1111111111111111111111111111111111
10000000000000P0000000000E00000001
1010010100100000101001000000010101
1010010010101010001001000000010101
1000000000000000000000000C00000001
1111111111111111111111111111111111
