1111111111111111111111111111111111
100000000000N0000000N0000000N00001
101001010010000010100N000000010101
1P00E0000C000N000000000000000000C1
1111111111111111111111111111111111
