1111111111111111111111111111111111
1E0000000000000C00000C0000N0000001
10100101001000001010010000N0010101
10100100101010100010010000NN010101
1P0000000C00C00000000000000N0000C1
1111111111111111111111111111111111
