1111111111111111111111111111111111
10E000000000N0000000N0000000N00001
1010010100100000101000000000010101
1P0000000C0000000000000000000000C1
1111111111111111111111111111111111
